a balavento	a_balavento
a baluto	a_baluto
a baravento	a_baravento
a barullo	a_barullo
a base de	a_base_de
ab intestato	ab_intestato
a bordo	a_bordo
a cabalo	a_cabalo
a cachapernas	a_cachapernas
a cachón	a_cachón
a cada canto	a_cada_canto
a cada pouco	a_cada_pouco
a cambio	a_cambio
a carón de	a_carón_de
a carón	a_carón
a carranchapernas	a_carranchapernas
a carranchas	a_carranchas
a cas de	a_cas_de
a causa de	a_causa_de
a ceacú	a_ceacú
a cegas	a_cegas
acerca de	acerca_de
a chupe	a_chupe
a consecuencia de	a_consecuencia_de
a conta de	a_conta_de
a continuación	a_continuación
a contragusto	a_contragusto
a contramán	a_contramán
a contrapelo	a_contrapelo
a correr	a_correr
a costa de	a_costa_de
a cotío	a_cotío
a dereitas	a_dereitas
a desbarate	a_desbarate
a desbarato	a_desbarato
a descomán	a_descomán
a deshora	a_deshora
a desmán	a_desmán
a destempo	a_destempo
ad hoc	ad_hoc
ad hominem	ad_hominem
a diario	a_diario
a diferencia de	a_diferencia_de
a diferenza de	a_diferenza_de
ad libitum	ad_libitum
ad litteram	ad_litteram
a doután	a_doután
ad pedem litteram	ad_pedem_litteram
a eito	a_eito
a embute	a_embute
a escape	a_escape
a esgalla	a_esgalla
a excepción de	a_excepción_de
a expensas de	a_expensas_de
a favor	a_favor
a feito	a_feito
a fin de contas	a_fin_de_contas
a fin de	a_fin_de
a flote	a_flote
a fondo	a_fondo
a fortiori	a_fortiori
a forza de	a_forza_de
a gatiñas	a_gatiñas
agora ben	agora_ben
agora que	agora_que
a granel	a_granel
a gusto	a_gusto
aínda así	aínda_así
aínda cando	aínda_cando
aínda que	aínda_que
a maiores	a_maiores
a mais	a_mais
a máis tardar	a_máis_tardar
a medias	a_medias
a medida que	a_medida_que
a menos que	a_menos_que
a miúdo	a_miúdo
a modiño	a_modo
a modo	a_modo
a nada que	a_nada_que
a nado	a_nado
a non ser que	a_non_ser_que
a non ser se	a_non_ser_se
ante meridiem	ante_meridiem
antes de antonte	antes_de_antonte
a o agacho	a_o_agacho
a o azar	a_o_azar
a o biés	a_o_biés
a o bordo de	a_o_bordo_de
a o cabo	a_o_cabo
a o carón de	a_o_carón_de
a o carón	a_o_carón
a o carricho	a_o_carricho
a o chou	a_o_chou
a o completo	a_o_completo
a o contrario	a_o_contrario
a o contraxeito	a_o_contraxeito
a o dereito	a_o_dereito
a o desbarate	a_o_desbarate
a o desbarato	a_o_desbarato
a o fin e a o cabo	a_o_fin_e_a_o_cabo
a o fin	a_o_fin
a o garete	a_o_garete
a o lado	a_o_lado
a o longo de	a_o_longo_de
a o mellor	a_o_mellor
a o menos	a_o_menos
a o momentiño	a_o_momento
a o momento	a_o_momento
a o nesgo	a_o_nesgo
a o outro día	a_o_outro_día
a o par de	a_o_par_de
a o par	a_o_par
a o pé de	a_o_pé_de
a o pé	a_o_pé
a o pouco	a_o_pouco
a o quite	a_o_quite
a o raro	a_o_raro
a o redor de	a_o_redor_de
a o redor	a_o_redor
a o rente	a_o_rente
a o respecto de	a_o_respecto_de
a o respecto	a_o_respecto
a o revés	a_o_revés
a os boleiróns	a_os_boleiróns
a os poucos	a_os_poucos
a os pouquiños	a_os_poucos
a os revorcos	a_os_revorcos
a o tanto	a_o_tanto
a o xeito	a_o_xeito
a par de	a_par_de
a partir de	a_partir_de
a pé	a_pé
a penas	a_penas
a penas	a_penas
a pesar de	a_pesar_de
a piques	a_piques
a poder de	a_poder_de
a por de	a_por_de
a posteriori	a_posteriori
a pouco que	a_pouco_que
a pre	a_pre
a priori	a_priori
a prol	a_prol
a propósito	a_propósito
a punto de	a_punto_de
a punto	a_punto
a queimarroupa	a_queimarroupa
a raíz de	a_raíz_de
a rastro	a_rastro
a razón de	a_razón_de
a rebolos	a_rebolos
a recú	a_recú
a regañadentes	a_regañadentes
a rente de	a_rente_de
a rente	a_rente
a rentes de	a_rentes_de
a rentes	a_rentes
a reo	a_reo
a requichas	a_requichas
a respecto de	a_respecto_de
a retortoiro	a_retortoiro
a rolos	a_rolos
arredor de	arredor_de
a sabendas	a_sabendas
a salvo	a_salvo
asemade que	asemade_que
así a todo	así_a_todo
así como	así_como
así e todo	así_e_todo
así mesmo	así_mesmo
así pois	así_pois
así que	así_que
así que	así_que
a son de	a_son_de
a son	a_son
a tempo	a_tempo
a tentas	a_tentas
a teor de	a_teor_de
a tergo	a_tergo
a toda costa	a_toda_costa
a tope	a_tope
a través de	a_través_de
a través	a_través
a traveso de	a_traveso_de
a treo	a_treo
a treu	a_treu
a un tempo	a_un_tempo
a xeito de	a_xeito_de
axiña que	axiña_que
a xuízo de	a_xuízo_de
bardante de	bardante_de
beira de	beira_de
ben como	ben_como
ben que	ben_que
boca abaixo	boca_abaixo
cabo de	cabo_de
cada vez que	cada_vez_que
camiño de	camiño_de
cando menos	cando_menos
cando queira que	cando_queira_que
canto a	canto_a
canto antes	canto_antes
cara a	cara_a
cas de	cas_de
case que	case_que
catar se	catar_se
como mínimo	como_mínimo
como queira que	como_queira_que
conforme a	conforme_a
con o gallo de	con_o_gallo_de
con relación a	con_relación_a
con respecto a	con_respecto_a
con tal de que	con_tal_de_que
con tal que	con_tal_que
con todo	con_todo
contra de	contra_de
dacordo con	dacordo_con
dado que	dado_que
de abondo	de_abondo
de a cabalo	de_a_cabalo
de acordo con	de_acordo_con
de acordo	de_acordo
de a feito	de_a_feito
de aí que	de_aí_que
de alí a pouco	de_alí_a_pouco
de alí a pouquiño	de_alí_a_pouco
de antemán	de_antemán
de aquí a pouco	de_aquí_a_pouco
de aquí a pouquiño	de_aquí_a_pouco
de balde	de_balde
de baluto	de_baluto
de bruzos	de_bruzos
de camiño	de_camiño
de cando en cando	de_cando_en_cando
de cando en vez	de_cando_en_vez
de cara a	de_cara_a
de carón de	de_carón_de
de carón	de_carón
de cas de	de_cas_de
de certo	de_certo
de cheo	de_cheo
de contadiño	de_contado
de contado	de_contado
decontado que	decontado_que
de contino	de_contino
de cor	de_cor
de cote	de_cote
de cotío	de_cotío
de crequenas	de_crequenas
de emprestado	de_emprestado
de esguello	de_esguello
de face	de_face
de facto	de_facto
de feito	de_feito
de forma que	de_forma_que
de fronte	de_fronte
de ganchete	de_ganchete
de garra	de_garra
de gatiñas	de_gatiñas
de golpe	de_golpe
deica pouco	deica_pouco
deica que	deica_que
deica un pouco	deica_un_pouco
de improviso	de_improviso
de inmediato	de_inmediato
de jure	de_jure
de longo	de_longo
de máis	de_máis
de maneira que	de_maneira_que
de menos	de_menos
de moca	de_moca
de modo que	de_modo_que
de momento	de_momento
dende logo	dende_logo
de non ser que	de_non_ser_que
de non ser se	de_non_ser_se
de novo	de_novo
dentro de	dentro_de
de oídas	de_oídas
de o revés	de_o_revés
de o trinque	de_o_trinque
de par de	de_par_de
de par en par	de_par_en_par
de pé	de_pé
de por vida	de_por_vida
de poutelas	de_poutelas
de présa	de_présa
de prestado	de_prestado
de primeiras	de_primeiras
de pronto	de_pronto
de propósito	de_propósito
de puntiñas	de_puntiñas
de querquena	de_querquena
de raíz	de_raíz
de raro en raro	de_raro_en_raro
de recú	de_recú
de reollo	de_reollo
de repente	de_repente
derredor de	derredor_de
desde logo	desde_logo
de seguida	de_seguida
deseguida que	deseguida_que
de seguidiña	de_seguida
de seguido	de_seguido
de sobra	de_sobra
de socate	de_socate
de socato	de_socato
des que	des_que
de súpeto	de_súpeto
de tempo en tempo	de_tempo_en_tempo
de todo	de_todo
de través de	de_través_de
de través	de_través
de vagariño	de_vagar
de vagar	de_vagar
de verdade	de_verdade
de vez en cando	de_vez_en_cando
de xeito que	de_xeito_que
e iso que	e_iso_que
e mais	e_mais
en absoluto	en_absoluto
en balde	en_balde
en baluto	en_baluto
en breve	en_breve
en cambio	en_cambio
en canto a	en_canto_a
en canto	en_canto
en canto que	en_canto_que
en cas de	en_cas_de
encol de	encol_de
en común	en_común
en conciencia	en_conciencia
en concreto	en_concreto
en contra	en_contra
en crequenas	en_crequenas
ende ben	ende_ben
en definitiva	en_definitiva
ende mal	ende_mal
en diante	en_diante
endoutro día	endoutro_día
en efecto	en_efecto
en especial	en_especial
en favor	en_favor
en fin	en_fin
en firme	en_firme
en fite	en_fite
en fronte de	en_fronte_de
en fronte	en_fronte
en función de	en_función_de
en materia de	en_materia_de
en o entanto	en_o_entanto
en o entanto	en_o_entanto
en o momento	en_o_momento
en par de	en_par_de
en parte	en_parte
en particular	en_particular
en pé	en_pé
en por de	en_por_de
en porrancho	en_porrancho
en precario	en_precario
en premier	en_premier
en principio	en_principio
en público	en_público
en punto	en_punto
en querquena	en_querquena
en rama	en_rama
en realidade	en_realidade
en relación a	en_relación_a
en relación con	en_relación_con
en seguida	en_seguida
en seguidiña	en_seguida
en tanto	en_tanto
en tanto que	en_tanto_que
en tempo	en_tempo
en teoría	en_teoría
en todo caso	en_todo_caso
en torno a	en_torno_a
entre lusco e fusco	entre_lusco_e_fusco
entre tanto	entre_tanto
en troques	en_troques
en vango	en_vango
en van	en_van
en verdade	en_verdade
en virtude de	en_virtude_de
en vivo	en_vivo
en xeral	en_xeral
ex aequo	ex_aequo
ex cathedra	ex_cathedra
ex profeso	ex_profeso
extra muros	extra_muros
fite a fite	fite_a_fite
fóra de	fóra_de
frente a	frente_a
fronte a	fronte_a
fronte por fronte	fronte_por_fronte
gracias a	gracias_a
grazas a	grazas_a
grosso modo	grosso_modo
honoris causa	honoris_causa
hoxe en día	hoxe_en_día
hoxe por hoxe	hoxe_por_hoxe
in albis	in_albis
in articulo mortis	in_articulo_mortis
in crescendo	in_crescendo
inda ben non	inda_ben_non
inda que	inda_que
in extremis	in_extremis
in folio	in_folio
in illo tempore	in_illo_tempore
in medias res	in_medias_res
in mente	in_mente
in octavo	in_octavo
in pectore	in_pectore
in quarto	in_quarto
in situ	in_situ
inter nos	inter_nos
intra muros	intra_muros
in vitro	in_vitro
in vivo	in_vivo
ipso facto	ipso_facto
lato sensu	lato_sensu
logo que	logo_que
máis ben	máis_ben
mal como	mal_como
mal que	mal_que
menos mal	menos_mal
mentras que	mentras_que
mentres antes	mentres_antes
mentres que	mentres_que
mentres tanto	mentres_tanto
mentres tanto	mentres_tanto
mesmo que	mesmo_que
motu propio	motu_propio
mutatis mutandis	mutatis_mutandis
nin que	nin_que
nin sequera	nin_sequera
nin siquer	nin_siquer
nin tan sequera	nin_tan_sequera
non embargante	non_embargante
non obstante	non_obstante
nun santiamén	nun_santiamén
onda non	onda_non
onde queira	onde_queira
onde quer	onde_quer
o outro antonte	o_outro_antonte
ora ben	ora_ben
ora que	ora_que
ou ben	ou_ben
ou sexa	ou_sexa
per cápita	per_cápita
per capita	per_capita
per se	per_se
pese a	pese_a
pois ben	pois_ben
pois que	pois_que
por adiantado	por_adiantado
por aí	por_aí
por ante	por_ante
por anticipado	por_anticipado
por canto	por_canto
por causa de	por_causa_de
por cen	por_cen
por cento	por_cento
por certo	por_certo
por conseguinte	por_conseguinte
por contra	por_contra
por cousa de	por_cousa_de
por culpa de	por_culpa_de
por encima	por_encima
por ende	por_ende
por enriba	por_enriba
por enteiro	por_enteiro
por escrito	por_escrito
por fas	por_fas
por fin	por_fin
por fortuna	por_fortuna
por igual	por_igual
por la contra	por_a_contra
por las boas	por_as_boas
por las malas	por_as_malas
por libre	por_libre
por lo baixo	por_o_baixo
por lo contrario	por_o_contrario
por lo menos	por_o_menos
por lo miúdo	por_o_miúdo
por lo momento	por_o_momento
por lo pronto	por_o_pronto
por los zarapelos	por_os_zarapelos
por lo tanto	por_o_tanto
por lo tanto	por_o_tanto
por máis que	por_máis_que
por medio de	por_medio_de
por moito que	por_moito_que
por mor de	por_mor_de
por nefas	por_nefas
por oídas	por_oídas
por pouco que	por_pouco_que
por riba	por_riba
por separado	por_separado
por suposto	por_suposto
por tanto	por_tanto
por tanto	por_tanto
por un tris	por_un_tris
por veces	por_veces
post meridiem	post_meridiem
posto que	posto_que
pouco a pouco	pouco_a_pouco
pouco e pouco	pouco_e_pouco
pouquiño a pouco	pouco_a_pouco
pro rata	pro_rata
respecto a	respecto_a
respecto de	respecto_de
se ben	se_ben
se cadra	se_cadra
se callar	se_callar
sempre e cando	sempre_e_cando
sempre que	sempre_que
sen dúbida	sen_dúbida
sen embargo	sen_embargo
senón que	senón_que
si ben	si_ben
sine die	sine_die
sine qua non	sine_qua_non
sobre de	sobre_de
só que	só_que
stricto sensu	stricto_sensu
strictu sensu	strictu_sensu
sub iudice	sub_iudice
sui generis	sui_generis
tal cal	tal_cal
tal vez	tal_vez
tan presto	tan_presto
tan pronto	tan_pronto
tras de	tras_de
unha vez	unha_vez
unha vez	unha_vez
unha vez que	unha_vez_que
urbi et orbi	urbi_et_orbi
verbi gratia	verbi_gratia
verbo de	verbo_de
visto que	visto_que
xa que	xa_que
xa que logo	xa_que_logo
xunto a	xunto_a
xunto con	xunto_con
xunto de	xunto_de
