a causa	a_causa
a causa di	a_causa_di
a confronto	a_confronto
a condizione che 	a_condizione_che
a cui	a_cui
a dispetto	a_dispetto
a dispetto di	a_dispetto_di
a forza	a_forza
a partire da	a_partire_da
a partire da ora	a_partire_da_ora
a priori	a_priori
a proposito	a_proposito
a questo punto	a_questo_punto
a rigore	a_rigore
a rischio 	a_rischio
a rischio di 	a_rischio_di
a sangue freddo	a_sangue_freddo
a tutt'oggi	a_tutt_oggi
ad esempio	ad_esempio
ad oggi	ad_oggi
ai ferri corti	ai_ferri_corti
ai quali	ai_quali
al confronto	al_confronto
al contrario	al_contrario
al di la	al_di_la
al di sopra	al_di_sopra
al fine 	al_fine_
al fine di	al_fine_di
al momento	al_momento
al posto	al_posto
al posto di	al_posto_di
al punto	al_punto
al quale	al_quale
al riguardo	al_riguardo
alla quale	alla_quale
alla volta	alla_volta
allo stesso tempo	allo_stesso_tempo
andare e venire	andare_e_venire
a questo	a_questo
arriere pensee	arriere_pensee
bagno maria	bagno_maria
basso ventre	basso_ventre
bella di notte	bella_di_notte
belle arti	belle_arti
ben altro	ben_altro
bla bla	bla_bla
black out 	black_out
boy scout 	boy_scout
bric a brac 	bric_a_brac
buon giorno	buon_giorno
buon lavoro	buon_lavoro
buona notte	buona_notte
buona sera 	buona_sera
camera oscura	camera_oscura
capo luogo	capo_luogo
chef d'oeuvre	chef_d_oeuvre
che magari	che_magari
chewing gum 	chewing_gum_
che poi	che_poi
ci sembra che	ci_sembra_che
cio che	cio_che
cio detto	cio_detto
cioe a dire	cioe_a_dire
cioe la	cioe_la
cioe se	cioe_se
colpo d'occhio	colpo_d_occhio
come dire	come_dire
come dire che	come_dire_che
come noi	come_noi
corto circuito	corto_circuito
cow boy 	cow_boy
cul de sac	cul_de_sac
d'accordo	d_accordo
da che	da_che
da cio	da_cio
d'ora in poi	d_ora_in_poi
da ora in poi	da_ora_in_poi
da quando	da_quando
da qui a	da_qui_a
dalle parti	dalle_parti
dalle parti di	dalle_parti_di
dato che	dato_che
del genere	del_genere
del momento	del_momento
del resto	del_resto
detto altrimenti	detto_altrimenti
detto cio	detto_cio
detto questo	detto_questo
di conseguenza	di_conseguenza
di continuo	di_continuo
di contro	di_contro
di cui	di_cui
di fronte	di_fronte
di fuori	di_fuori
di lesa maesta	di_lesa_maesta
di natura	di_natura
di piu	di_piu
di questa	di_questa
di questo	di_questo
di seguito	di_seguito
di seguito	di_seguito
di traverso	di_traverso
di una	di_una
dopo domani	dopo_domani
drug store	drug_store
e che	e_che
e che	e_che
e come	e_come
e perche	e_perche
e poi	e_poi
e quindi	e_quindi
e vero	e_vero
ex libris 	ex_libris
ex voto 	ex_voto
fac simile	fac_simile
faccia a faccia	faccia_a_faccia
far parte	far_parte
far parte di	far_parte_di
fatta da	fatta_da
fatti da	fatti_da
fatto da	fatto_da
fatto salvo che	fatto_salvo_che
ferry boat	ferry_boat
franco tiratore	franco_tiratore
frou frou 	frou_frou
fuori legge	fuori_legge
gratta culo	gratta_culo
grazia di dio	grazia_di_dio
ha detto	ha_detto
hanno detto	hanno_detto
ieri l'altro	ieri_l_altro
in alto	in_alto
in basso	in_basso
in che	in_che
in conclusione	in_conclusione
in corso	in_corso
in cui	in_cui
in definitiva	in_definitiva
in effetti	in_effetti
in fondo	in_fondo
in generale	in_generale
in loco	in_loco
in luogo	in_luogo
in modo	in_modo
in modo che	in_modo_che
in moto	in_moto
in ogni caso	in_ogni_caso
in ogni modo	in_ogni_modo
in particolare	in_particolare
in piu	in_piu
in qualche modo	in_qualche_modo
in questo	in_questo
in realta	in_realta
in senso lato	in_senso_lato
in testa	in_testa
in tutti i casi	in_tutti_i_casi
in vano	in_vano
in vista di	in_vista_di
la davanti	la_davanti
la sopra	la_sopra
la sotto	la_sotto
lancia fiamme	lancia_fiamme
lasciar fare	lasciar_fare
lasciare fare	lasciare_fare
lesa maesta	lesa_maesta
lontando dal	lontando_dal
luogo comune	luogo_comune
martin pesacatore	martin_pesacatore
messa in atto	messa_in_atto
messa in opera	messa_in_opera
metterci una pezza	metterci_una_pezza
mezza stagione	mezza_stagione
mezzo giorno	mezzo_giorno
mezzo male	mezzo_male
mi sembra che	mi_sembra_che
neanche per niente	neanche_per_niente
nei confronti	nei_confronti
nel caso	nel_caso
nel caso in cui	nel_caso_in_cui
nel senso	nel_senso
nel momento in cui	nel_momento_in_cui
nella misura in cui	nella_misura_in_cui
non conformista	non_conformista
non importa 	non_importa
non senso	non_senso
non so	non_so
non lo so	non_lo_so
non violento	non_violento
nuovo giorno	nuovo_giorno
o meno	o_meno
parlare chiaro	parlare_chiaro
parlare franco	parlare_franco
passa tempo	passa_tempo
per altro	per_altro
per andare	per_andare
per augurio	per_augurio
per concludere	per_concludere
per cosi dire	per_cosi_dire
per cui	per_cui
per esempio	per_esempio
per essere chiari	per_essere_chiari
per fare un esempio	per_fare_un_esempio
per finire	per_finire
per forza	per_forza
per la ragione che	per_la_ragione_che
per natura	per_natura
per niente	per_niente
per parlare chiaro	per_parlare_chiaro
per questo	per_questo
per riguardo	per_riguardo
pero insomma	pero_insomma
pick up 	pick_up
pied a terre	pied_a_terre
piu che	piu_che
piu di	piu_di
piu o meno	piu_o_meno
popo a poco	popo_a_poco
porta bagagli	porta_bagagli
porta chiavi	porta_chiavi
porta parola	porta_parola
porta penne	porta_penne
porta sigarette	porta_sigarette
porta voce	porta_voce
post scriptum 	post_scriptum
prima di tutto	prima_di_tutto
puo darsi	puo_darsi
puo essere	puo_essere
puo essere che	puo_essere_che
qualche cosa	qualche_cosa
quanto a 	quanto_a
quanto a me	quanto_a_me
quanto a noi	quanto_a_noi
quanto a te	quanto_a_te
quanto a voi	quanto_a_voi
quelli che	quelli_che
quelli la	quelli_la
quelli li	quelli_li
quello che	quello_che
quello la	quello_la
quello li	quello_li
regno unito	regno_unito
retro gusto	retro_gusto
rispetto al	rispetto_al
rispetto alle	rispetto_alle
sangue freddo	sangue_freddo
savoir faire	savoir_faire
se dicente	se_dicente
secondo me	secondo_me
senza logica	senza_logica
senza pausa	senza_pausa
senza testa	senza_testa
se poi	se_poi
se uno	se_uno
si salvi chi puo	si_salvi_chi_puo
side car	side_car
sono stati	sono_stati
sotto bosco	sotto_bosco
sotto cutanea	sotto_cutanea
sotto prodotto	sotto_prodotto
sotto sotto	sotto_sotto
sotto sviluppato	sotto_sviluppato
sotto terra	sotto_terra
stando ai fatti	stando_ai_fatti
stando cio	stando_cio
stando cosi le cose	stando_cosi_le_cose
stati uniti	stati_uniti
stato maggiore	stato_maggiore
tam tam 	tam_tam
tanto che	tanto_che
tanto ha fatto che	tanto_ha_fatto_che
tanto per dire	tanto_per_dire
tanto per fare	tanto_per_fare
tenuto conto	tenuto_conto
testa a testa	testa_a_testa
testa coda	testa_coda
tirare dritto	tirare_dritto
tra chi	tra_chi
tra loro	tra_loro
tra noi	tra_noi
tre quarti	tre_quarti
tutt'a un tratto	tutt_a_un_tratto
tutti i santi	tutti_i_santi
tutto compreso	tutto_compreso
una grande cosa	una_grande_cosa
un attimo	un_attimo
un certo	un_certo
un po	un_po
una volta	una_volta
va e viene	va_e_viene
vagone letto	vagone_letto
vagone ristorante	vagone_ristorante
vice presidente	vice_presidente
vicino a 	vicino_a
vicino ai	vicino_ai
volta faccia	volta_faccia
wagon lit 	wagon_lit
wagon restaurant	wagon_restaurant
week end	week_end
