aderton	aderton	sw
adertonde	adertonde	sw
adjö	adjö	sw
aldrig	aldrig	sw
alla	alla	sw
allas	allas	sw
allt	allt	sw
alltid	alltid	sw
alltså	alltså	sw
än	än	sw
andra	andra	sw
andras	andras	sw
annan	annan	sw
annat	annat	sw
ännu	ännu	sw
är	är	sw
artonde	artonde	sw
artonn	artonn	sw
åtminstone	åtminstone	sw
att	att	sw
åtta	åtta	sw
åttio	åttio	sw
åttionde	åttionde	sw
åttonde	åttonde	sw
av	av	sw
även	även	sw
båda	båda	sw
bådas	bådas	sw
bakom	bakom	sw
bara	bara	sw
bäst	bäst	sw
bättre	bättre	sw
behöva	behöva	sw
behövas	behövas	sw
behövde	behövde	sw
behövt	behövt	sw
beslut	beslut	sw
beslutat	beslutat	sw
beslutit	beslutit	sw
bland	bland	sw
blev	blev	sw
bli	bli	sw
blir	blir	sw
blivit	blivit	sw
bort	bort	sw
borta	borta	sw
bra	bra	sw
då	då	sw
dag	dag	sw
dagar	dagar	sw
dagarna	dagarna	sw
dagen	dagen	sw
där	där	sw
därför	därför	sw
de	de	sw
del	del	sw
delen	delen	sw
dem	dem	sw
den	den	sw
deras	deras	sw
dess	dess	sw
det	det	sw
detta	detta	sw
dig	dig	sw
din	din	sw
dina	dina	sw
dit	dit	sw
ditt	ditt	sw
dock	dock	sw
du	du	sw
efter	efter	sw
eftersom	eftersom	sw
elfte	elfte	sw
eller	eller	sw
elva	elva	sw
en	en	sw
enkel	enkel	sw
enkelt	enkelt	sw
enkla	enkla	sw
enligt	enligt	sw
er	er	sw
era	era	sw
ert	ert	sw
ett	ett	sw
ettusen	ettusen	sw
få 	få 	sw
fanns	fanns	sw
får	får	sw
fått 	fått 	sw
fem	fem	sw
femte	femte	sw
femtio	femtio	sw
femtionde	femtionde	sw
femton	femton	sw
femtonde	femtonde	sw
fick	fick	sw
fin	fin	sw
finnas	finnas	sw
finns	finns	sw
fjärde	fjärde	sw
fjorton	fjorton	sw
fjortonde	fjortonde	sw
fler	fler	sw
flera	flera	sw
flesta	flesta	sw
följande	följande	sw
för	för	sw
före	före	sw
förlåt	förlåt	sw
förra	förra	sw
första	första	sw
fram	fram	sw
framför	framför	sw
från	från	sw
fyra	fyra	sw
fyrtio	fyrtio	sw
fyrtionde	fyrtionde	sw
gå	gå	sw
gälla	gälla	sw
gäller	gäller	sw
gällt	gällt	sw
går	går	sw
gärna	gärna	sw
gått	gått	sw
genast	genast	sw
genom	genom	sw
gick	gick	sw
gjorde	gjorde	sw
gjort	gjort	sw
god	god	sw
goda	goda	sw
godare	godare	sw
godast	godast	sw
gör	gör	sw
göra	göra	sw
gott	gott	sw
ha	ha	sw
hade	hade	sw
haft	haft	sw
han	han	sw
hans	hans	sw
har	har	sw
här	här	sw
heller	heller	sw
hellre	hellre	sw
helst	helst	sw
helt	helt	sw
henne	henne	sw
hennes	hennes	sw
hit	hit	sw
hög	hög	sw
höger	höger	sw
högre	högre	sw
högst	högst	sw
hon	hon	sw
honom	honom	sw
hundra	hundra	sw
hundraen	hundraen	sw
hundraett	hundraett	sw
hur	hur	sw
i	i	sw
ibland	ibland	sw
idag	idag	sw
igår	igår	sw
igen	igen	sw
imorgon	imorgon	sw
in	in	sw
inför	inför	sw
inga	inga	sw
ingen	ingen	sw
ingenting	ingenting	sw
inget	inget	sw
innan	innan	sw
inne	inne	sw
inom	inom	sw
inte	inte	sw
inuti	inuti	sw
ja	ja	sw
jag	jag	sw
jämfört	jämfört	sw
kan	kan	sw
kanske	kanske	sw
knappast	knappast	sw
kom	kom	sw
komma	komma	sw
kommer	kommer	sw
kommit	kommit	sw
kr	kr	sw
kunde	kunde	sw
kunna	kunna	sw
kunnat	kunnat	sw
kvar	kvar	sw
länge	länge	sw
längre	längre	sw
långsam	långsam	sw
långsammare	långsammare	sw
långsammast	långsammast	sw
långsamt	långsamt	sw
längst	längst	sw
långt	långt	sw
lätt	lätt	sw
lättare	lättare	sw
lättast	lättast	sw
legat	legat	sw
ligga	ligga	sw
ligger	ligger	sw
lika	lika	sw
likställd	likställd	sw
likställda	likställda	sw
lilla	lilla	sw
lite	lite	sw
liten	liten	sw
litet	litet	sw
man	man	sw
många	många	sw
måste	måste	sw
med	med	sw
mellan	mellan	sw
men	men	sw
mer	mer	sw
mera	mera	sw
mest	mest	sw
mig	mig	sw
min	min	sw
mina	mina	sw
mindre	mindre	sw
minst	minst	sw
mitt	mitt	sw
mittemot	mittemot	sw
möjlig	möjlig	sw
möjligen	möjligen	sw
möjligt	möjligt	sw
möjligtvis	möjligtvis	sw
mot	mot	sw
mycket	mycket	sw
någon	någon	sw
någonting	någonting	sw
något	något	sw
några	några	sw
när	när	sw
nästa	nästa	sw
ned	ned	sw
nederst	nederst	sw
nedersta	nedersta	sw
nedre	nedre	sw
nej	nej	sw
ner	ner	sw
ni	ni	sw
nio	nio	sw
nionde	nionde	sw
nittio	nittio	sw
nittionde	nittionde	sw
nitton	nitton	sw
nittonde	nittonde	sw
nödvändig	nödvändig	sw
nödvändiga	nödvändiga	sw
nödvändigt	nödvändigt	sw
nödvändigtvis	nödvändigtvis	sw
nog	nog	sw
noll	noll	sw
nr	nr	sw
nu	nu	sw
nummer	nummer	sw
och	och	sw
också	också	sw
ofta	ofta	sw
oftast	oftast	sw
olika	olika	sw
olikt	olikt	sw
om	om	sw
oss	oss	sw
över	över	sw
övermorgon	övermorgon	sw
överst	överst	sw
övre	övre	sw
på	på	sw
rakt	rakt	sw
rätt	rätt	sw
redan	redan	sw
så	så	sw
sade	sade	sw
säga	säga	sw
säger	säger	sw
sagt	sagt	sw
samma	samma	sw
sämre	sämre	sw
sämst	sämst	sw
sedan	sedan	sw
senare	senare	sw
senast	senast	sw
sent	sent	sw
sex	sex	sw
sextio	sextio	sw
sextionde	sextionde	sw
sexton	sexton	sw
sextonde	sextonde	sw
sig	sig	sw
sin	sin	sw
sina	sina	sw
sist	sist	sw
sista	sista	sw
siste	siste	sw
sitt	sitt	sw
sjätte	sjätte	sw
sju	sju	sw
sjunde	sjunde	sw
sjuttio	sjuttio	sw
sjuttionde	sjuttionde	sw
sjutton	sjutton	sw
sjuttonde	sjuttonde	sw
ska	ska	sw
skall	skall	sw
skulle	skulle	sw
slutligen	slutligen	sw
små	små	sw
smått	smått	sw
snart	snart	sw
som	som	sw
stor	stor	sw
stora	stora	sw
större	större	sw
störst	störst	sw
stort	stort	sw
tack	tack	sw
tidig	tidig	sw
tidigare	tidigare	sw
tidigast	tidigast	sw
tidigt	tidigt	sw
till	till	sw
tills	tills	sw
tillsammans	tillsammans	sw
tio	tio	sw
tionde	tionde	sw
tjugo	tjugo	sw
tjugoen	tjugoen	sw
tjugoett	tjugoett	sw
tjugonde	tjugonde	sw
tjugotre	tjugotre	sw
tjugotvå	tjugotvå	sw
tjungo	tjungo	sw
tolfte	tolfte	sw
tolv	tolv	sw
tre	tre	sw
tredje	tredje	sw
trettio	trettio	sw
trettionde	trettionde	sw
tretton	tretton	sw
trettonde	trettonde	sw
två	två	sw
tvåhundra	tvåhundra	sw
under	under	sw
upp	upp	sw
ur	ur	sw
ursäkt	ursäkt	sw
ut	ut	sw
utan	utan	sw
utanför	utanför	sw
ute	ute	sw
vad	vad	sw
vänster	vänster	sw
vänstra	vänstra	sw
var	var	sw
vår	vår	sw
vara	vara	sw
våra	våra	sw
varför	varför	sw
varifrån	varifrån	sw
varit	varit	sw
varken	varken	sw
värre	värre	sw
varsågod	varsågod	sw
vart	vart	sw
vårt	vårt	sw
vem	vem	sw
vems	vems	sw
verkligen	verkligen	sw
vi	vi	sw
vid	vid	sw
vidare	vidare	sw
viktig	viktig	sw
viktigare	viktigare	sw
viktigast	viktigast	sw
viktigt	viktigt	sw
vilka	vilka	sw
vilken	vilken	sw
vilket	vilket	sw
vill	vill	sw
a	a	sw
b	b	sw
c	c	sw
d	d	sw
e	e	sw
f	f	sw
g	g	sw
h	h	sw
i	i	sw
j	j	sw
k	k	sw
l	l	sw
m	m	sw
n	n	sw
o	o	sw
p	p	sw
q	q	sw
r	r	sw
s	s	sw
t	t	sw
u	u	sw
v	v	sw
w	w	sw
x	x	sw
y	y	sw
z	z	sw
