και	και	sw
του	του	sw
το	το	sw
της	της	sw
η	η	sw
την	την	sw
ο	ο	sw
από	από	sw
με	με	sw
να	να	sw
που	που	sw
των	των	sw
στην	στην	sw
για	για	sw
τον	τον	sw
σε	σε	sw
στο	στο	sw
τα	τα	sw
οι	οι	sw
τη	τη	sw
τους	τους	sw
στη	στη	sw
τις	τις	sw
α	α	sw
ως	ως	sw
στις	στις	sw
ή	ή	sw
ότι	ότι	sw
στον	στον	sw
στα	στα	sw
μια	μια	sw
π	π	sw
β	β	sw
σ	σ	sw
ενώ	ενώ	sw
χ	χ	sw
οποία	οποία	sw
αν	αν	sw
δ	δ	sw
γ	γ	sw
στους	στους	sw
ου	ου	sw
ε	ε	sw
μία	μία	sw
κ	κ	sw
μ	μ	sw
ένας	ένας	sw
πιο	πιο	sw
ν	ν	sw
σελ	σελ	sw
ς	ς	sw
πως	πως	sw
ενός	ενός	sw
μα	μα	sw
ος	ος	sw
αυτά	αυτά	sw
κή	κή	sw
κός	κός	sw
μου	μου	sw
σαν	σαν	sw
δε	δε	sw
υπό	υπό	sw
επί	επί	sw
κι	κι	sw
εν	εν	sw
ι	ι	sw
μη	μη	sw
μας	μας	sw
έως	έως	sw
αφού	αφού	sw
μιας	μιας	sw
τ	τ	sw
προ	προ	sw
κό	κό	sw
αυτές	αυτές	sw
τόσο	τόσο	sw
ας	ας	sw
όσο	όσο	sw
κάτι	κάτι	sw
ανά	ανά	sw
τι	τι	sw
μέσω	μέσω	sw
λα	λα	sw
εκ	εκ	sw
αυτός	αυτός	sw
είτε	είτε	sw
μην	μην	sw
παρά	παρά	sw
περί	περί	sw
εδώ	εδώ	sw
αχα	αχα	sw
κής	κής	sw
ήδη	ήδη	sw
ντε	ντε	sw
σου	σου	sw
απ	απ	sw
ούτε	ούτε	sw
φ	φ	sw
αυτού	αυτού	sw
αυτών	αυτών	sw
εκδ	εκδ	sw
όλη	όλη	sw
χλμ	χλμ	sw
άνω	άνω	sw
πάλι	πάλι	sw
ης	ης	sw
κού	κού	sw
εκατομ	εκατομ	sw
όλοι	όλοι	sw
σας	σας	sw
καὶ	καὶ	sw
λ	λ	sw
όλο	όλο	sw
θ	θ	sw
οποίου	οποίου	sw
γι	γι	sw
εις	εις	sw
αυτούς	αυτούς	sw
κλπ	κλπ	sw
εξ	εξ	sw
κατ	κατ	sw
αυτοί	αυτοί	sw
στ	στ	sw
τομ	τομ	sw
φκ	φκ	sw
αντί	αντί	sw
ό	ό	sw
αι	αι	sw
ρ	ρ	sw
ζ	ζ	sw
ά	ά	sw
κά	κά	sw
απο	απο	sw
υ	υ	sw
εάν	εάν	sw
κές	κές	sw
πώς	πώς	sw
ημ	ημ	sw
ιι	ιι	sw
κα	κα	sw
αλ	αλ	sw
δὲ	δὲ	sw
αγ	αγ	sw
βπ	βπ	sw
ελ	ελ	sw
δια	δια	sw
βλ	βλ	sw
κών	κών	sw
και	και	sw
του	του	sw
της	της	sw
το	το	sw
να	να	sw
την	την	sw
η	η	sw
με	με	sw
που	που	sw
των	των	sw
για	για	sw
ότι	ότι	sw
τους	τους	sw
τα	τα	sw
δεν	δεν	sw
είναι	είναι	sw
ο	ο	sw
από	από	sw
τη	τη	sw
οι	οι	sw
σε	σε	sw
τον	τον	sw
τις	τις	sw
στην	στην	sw
στο	στο	sw
απ	απ	sw
μας	μας	sw
κι	κι	sw
στη	στη	sw
θα	θα	sw
μια	μια	sw
αλλά	αλλά	sw
στα	στα	sw
αυτό	αυτό	sw
ένα	ένα	sw
όχι	όχι	sw
ή	ή	sw
μόνο	μόνο	sw
αυτή	αυτή	sw
σαν	σαν	sw
ήταν	ήταν	sw
στις	στις	sw
στον	στον	sw
όπως	όπως	sw
αν	αν	sw
όμως	όμως	sw
σήμερα	σήμερα	sw
ενώ	ενώ	sw
γιατί	γιατί	sw
έχει	έχει	sw
ν	ν	sw
λοιπόν	λοιπόν	sw
σ	σ	sw
καί	καί	sw
αφού	αφού	sw
ούτε	ούτε	sw
όσο	όσο	sw
χωρίς	χωρίς	sw
μετά	μετά	sw
τόσο	τόσο	sw
είχε	είχε	sw
μπορεί	μπορεί	sw
χώρα	χώρα	sw
στους	στους	sw
έτσι	έτσι	sw
είτε	είτε	sw
δύο	δύο	sw
ακόμη	ακόμη	sw
πιο	πιο	sw
έχουν	έχουν	sw
αυτά	αυτά	sw
όπου	όπου	sw
όταν	όταν	sw
πάνω	πάνω	sw
άλλη	άλλη	sw
πάρα	πάρα	sw
χρόνια	χρόνια	sw
όλα	όλα	sw
αυτοί	αυτοί	sw
επί	επί	sw
αυτές	αυτές	sw
ένας	ένας	sw
οποία	οποία	sw
μέχρι	μέχρι	sw
βέβαια	βέβαια	sw
κατά	κατά	sw
σημερινή	σημερινή	sw
μη	μη	sw
αυτός	αυτός	sw
εδώ	εδώ	sw
τότε	τότε	sw
δήθεν	δήθεν	sw
αυτήν	αυτήν	sw
πρέπει	πρέπει	sw
πού	πού	sw
μην	μην	sw
ίδια	ίδια	sw
υπάρχει	υπάρχει	sw
σας	σας	sw
δηλαδή	δηλαδή	sw
κανένα	κανένα	sw
γι	γι	sw
πολύ	πολύ	sw
μ	μ	sw
αυτής	αυτής	sw
όλες	όλες	sw
παρά	παρά	sw
όλοι	όλοι	sw
τι	τι	sw
κάθε	κάθε	sw
εμείς	εμείς	sw
πριν	πριν	sw
καμιά	καμιά	sw
όσα	όσα	sw
κ	κ	sw
δε	δε	sw
τίς	τίς	sw
προς	προς	sw
ποτέ	ποτέ	sw
παρ	παρ	sw
κυρίως	κυρίως	sw
αυτούς	αυτούς	sw
έχουμε	έχουμε	sw
μιας	μιας	sw
κανένας	κανένας	sw
κάνει	κάνει	sw
πίσω	πίσω	sw
πια	πια	sw
είχαν	είχαν	sw
αμέσως	αμέσως	sw
έναν	έναν	sw
έγινε	έγινε	sw
γίνεται	γίνεται	sw
άλλους	άλλους	sw
άλλο	άλλο	sw
τίποτε	τίποτε	sw
πρόκειται	πρόκειται	sw
ακριβώς	ακριβώς	sw
ίδιο	ίδιο	sw
χιλιάδες	χιλιάδες	sw
περίπου	περίπου	sw
μπροστά	μπροστά	sw
επειδή	επειδή	sw
βρίσκεται	βρίσκεται	sw
υπάρχουν	υπάρχουν	sw
τουλάχιστον	τουλάχιστον	sw
πούναι	πούναι	sw
οποιαδήποτε	οποιαδήποτε	sw
πάλι	πάλι	sw
ενός	ενός	sw
είχαμε	είχαμε	sw
ανάμεσα	ανάμεσα	sw
άλλες	άλλες	sw
πρώτη	πρώτη	sw
πρόσφατα	πρόσφατα	sw
κάνουν	κάνουν	sw
δεύτερο	δεύτερο	sw
δεκάδες	δεκάδες	sw
h	h	sw
πρώην	πρώην	sw
πάντα	πάντα	sw
μόνη	μόνη	sw
λόγω	λόγω	sw
αυτών	αυτών	sw
άλλωστε	άλλωστε	sw
άλλων	άλλων	sw
υπήρξε	υπήρξε	sw
ορισμένες	ορισμένες	sw
οποίο	οποίο	sw
δυο	δυο	sw
ας	ας	sw
όσοι	όσοι	sw
σχεδόν	σχεδόν	sw
μπορούν	μπορούν	sw
μέρες	μέρες	sw
μάλιστα	μάλιστα	sw
δ	δ	sw
έγιναν	έγιναν	sw
όλη	όλη	sw
κάτι	κάτι	sw
εν	εν	sw
άλλοι	άλλοι	sw
φαίνεται	φαίνεται	sw
τρεις	τρεις	sw
τρίτου	τρίτου	sw
πώς	πώς	sw
λένε	λένε	sw
κλπ	κλπ	sw
κάποιος	κάποιος	sw
κάποια	κάποια	sw
εκτός	εκτός	sw
δισεκατομμύρια	δισεκατομμύρια	sw
γίνει	γίνει	sw
απέναντι	απέναντι	sw
σημερινό	σημερινό	sw
πλέον	πλέον	sw
πέρα	πέρα	sw
κανείς	κανείς	sw
καν	καν	sw
αυτού	αυτού	sw
έστω	έστω	sw
όλους	όλους	sw
φορές	φορές	sw
φορά	φορά	sw
πρόσφατη	πρόσφατη	sw
περί	περί	sw
νάχει	νάχει	sw
νάναι	νάναι	sw
μεγάλο	μεγάλο	sw
μεγάλη	μεγάλη	sw
εξής	εξής	sw
αυτόν	αυτόν	sw
έκανε	έκανε	sw
τέτοιο	τέτοιο	sw
σημερινές	σημερινές	sw
π	π	sw
ορισμένα	ορισμένα	sw
οποίες	οποίες	sw
οποίας	οποίας	sw
καμία	καμία	sw
διάφορα	διάφορα	sw
τώρα	τώρα	sw
τέτοια	τέτοια	sw
τέτια	τέτια	sw
τ	τ	sw
πιστεύουμε	πιστεύουμε	sw
μία	μία	sw
θάχε	θάχε	sw
θ	θ	sw
βρίσκονται	βρίσκονται	sw
άλλα	άλλα	sw
όλων	όλων	sw
ψέμα	ψέμα	sw
σχετικά	σχετικά	sw
πούμε	πούμε	sw
ποιος	ποιος	sw
λέγαμε	λέγαμε	sw
κάποιο	κάποιο	sw
ιδιαίτερα	ιδιαίτερα	sw
εκατομμύρια	εκατομμύρια	sw
ε	ε	sw
δισεκατομμυρίων	δισεκατομμυρίων	sw
γ	γ	sw
αλλού	αλλού	sw
ίσως	ίσως	sw
ώστε	ώστε	sw
όσους	όσους	sw
όσον	όσον	sw
τρίτο	τρίτο	sw
ποιον	ποιον	sw
μόλις	μόλις	sw
μεγάλες	μεγάλες	sw
δεύτερη	δεύτερη	sw
έχοντας	έχοντας	sw
έκαναν	έκαναν	sw
ότου	ότου	sw
όντας	όντας	sw
ό	ό	sw
τρίτη	τρίτη	sw
συνεχείς	συνεχείς	sw
συνήθως	συνήθως	sw
συνέχεια	συνέχεια	sw
πρώτο	πρώτο	sw
πέντε	πέντε	sw
ορισμένοι	ορισμένοι	sw
μέχρις	μέχρις	sw
καθένας	καθένας	sw
καθένα	καθένα	sw
θέλει	θέλει	sw
θάταν	θάταν	sw
επίσης	επίσης	sw
εκατομμυρίων	εκατομμυρίων	sw
εισαγγελέα	εισαγγελέα	sw
β	β	sw
έμμεση	έμμεση	sw
άμεσης	άμεσης	sw
άλλος	άλλος	sw
eνώ	eνώ	sw
όλο	όλο	sw
χιλιάδων	χιλιάδων	sw
φ	φ	sw
τί	τί	sw
στ	στ	sw
πρώτος	πρώτος	sw
πρώτα	πρώτα	sw
πούχουν	πούχουν	sw
πούχει	πούχει	sw
ποιο	ποιο	sw
ποια	ποια	sw
οποίους	οποίους	sw
νάχουν	νάχουν	sw
μεγαλύτερα	μεγαλύτερα	sw
μεγάλων	μεγάλων	sw
μεγάλα	μεγάλα	sw
μήπως	μήπως	sw
μήνα	μήνα	sw
λ	λ	sw
κάπως	κάπως	sw
ελλ	ελλ	sw
εκ	εκ	sw
δεκαετίες	δεκαετίες	sw
δεκαετία	δεκαετία	sw
απόλυτα	απόλυτα	sw
α	α	sw
ίδιος	ίδιος	sw
έξω	έξω	sw
άρα	άρα	sw
τρία	τρία	sw
τησ	τησ	sw
πάσης	πάσης	sw
πάντες	πάντες	sw
οποίου	οποίου	sw
ολόκληρη	ολόκληρη	sw
μπορούσαν	μπορούσαν	sw
μεταξύ	μεταξύ	sw
μεγαλύτερη	μεγαλύτερη	sw
λέμε	λέμε	sw
χρειάζεται	χρειάζεται	sw
χ	χ	sw
υπό	υπό	sw
τριών	τριών	sw
τούτοις	τούτοις	sw
πρόσφατες	πρόσφατες	sw
πούχε	πούχε	sw
λίγο	λίγο	sw
εξ	εξ	sw
εκατοντάδων	εκατοντάδων	sw
εκατοντάδες	εκατοντάδες	sw
απλή	απλή	sw
ακόμα	ακόμα	sw
τισ	τισ	sw
τέτιο	τέτιο	sw
τέτιες	τέτιες	sw
πόσο	πόσο	sw
παντού	παντού	sw
ορισμένους	ορισμένους	sw
οποιοσδήποτε	οποιοσδήποτε	sw
λλοι	λλοι	sw
επιπλέον	επιπλέον	sw
δικό	δικό	sw
δικούς	δικούς	sw
δι	δι	sw
δεκάδων	δεκάδων	sw
ήδη	ήδη	sw
άλλου	άλλου	sw
tόσο	tόσο	sw
kι	kι	sw
aν	aν	sw
υ	υ	sw
τέτοιες	τέτοιες	sw
πράγματι	πράγματι	sw
ποιοι	ποιοι	sw
πιστεύει	πιστεύει	sw
παραπάνω	παραπάνω	sw
οποιασδήποτε	οποιασδήποτε	sw
μπορέσει	μπορέσει	sw
μικρό	μικρό	sw
μερικές	μερικές	sw
μεγαλύτερες	μεγαλύτερες	sw
λες	λες	sw
κάποιου	κάποιου	sw
κάνοντας	κάνοντας	sw
ιδίως	ιδίως	sw
θέλουν	θέλουν	sw
θάπρεπε	θάπρεπε	sw
εκεί	εκεί	sw
ίδιους	ίδιους	sw
έπρεπε	έπρεπε	sw
όποιον	όποιον	sw
όποιο	όποιο	sw
τρισεκατομμύριο	τρισεκατομμύριο	sw
τρίτος	τρίτος	sw
τουσ	τουσ	sw
στισ	στισ	sw
σου	σου	sw
ρα	ρα	sw
ρ	ρ	sw
πως	πως	sw
πολλές	πολλές	sw
παρότι	παρότι	sw
πέρσι	πέρσι	sw
οποίων	οποίων	sw
νάγινε	νάγινε	sw
μπορείτε	μπορείτε	sw
μισού	μισού	sw
μισή	μισή	sw
μεγάλης	μεγάλης	sw
μακριά	μακριά	sw
λλος	λλος	sw
λίγες	λίγες	sw
λίγα	λίγα	sw
κανέναν	κανέναν	sw
θάναι	θάναι	sw
εξίσου	εξίσου	sw
εντούτοις	εντούτοις	sw
δια	δια	sw
δηλ	δηλ	sw
γύρω	γύρω	sw
γίνονταν	γίνονταν	sw
αύριο	αύριο	sw
αργότερα	αργότερα	sw
ήξερε	ήξερε	sw
έχετε	έχετε	sw
tο	tο	sw
mε	mε	sw
eτσι	eτσι	sw
aπ	aπ	sw
5ης	5ης	sw
50%	50%	sw
μή	μή	sw
